##################################################
#S....#..............#..............#..........###
#.####.#.############.#.############.#.########.##
#.#....#.#..........#.#.#..........#.#.#......#.##
#.#.####.#.########.#.#.#.########.#.#.#.####.#.##
#.#.#....#.#......#.#.#.#.#......#.#.#.#.#..#.#.##
#.#.#.####.#.####.#.#.#.#.#.####.#.#.#.#.#.##.#.#.
#...#......#.#....#...#...#.#....#...#...#.#....##
###########.#.#.###############.#.################
#...........#.#.................#...............##
#.###########.###################.#############.##
#.#...........#...................#...........#.##
#.#.###########.###################.#########.#.##
#.#.#...........#.........#.........#.......#.#.##
#.#.#.###########.#######.#.#######.#########.#.#.
#.#.#.#...........#.....#.#.#.....#...........#.#.
#.#.#.#.###########.###.#.#.#.###.#############.#.
#.#...#.#...........#.#.#...#.#.#...............#.
#.#####.#.###########.#.#####.#.#################.
#.......#.............#.......#.................##
###############.#########################.########
#...............#.........................#......#
#.###############.#########################.#.####
#.#...............#.........................#.#...
#.#.###############.#########################.#.#.
#.#.#...............#...............#.........#.#.
#.#.#.###############.#############.#.#########.#.
#...#...............#.............#.#...........#.
#########.#######################.#.#############.
#.........#.......................#...............
#.#########.#############################.########
#.#.........#.............................#.......
#.#.#########.#############################.#####.
#.#.#.........#...................#.........#...#.
#.#.#.#########.#################.#.#########.#.#.
#.#.#.#.........#...............#.#.#.........#.#.
#.#.#.#.#########.#############.#.#.#.#########.#.
#...#.#...........#.............#...#...........#.
#####.#############.#############################.
#...................#.............................
#.#################.#############################.
#.#.................#...............#.............
#.#.###############.###############.#.###########.
#.#.#...............#...............#.#.........#.
#.#.#.###############.###############.#.#.#######.
#...#...............#...............#...#.......#.
#############.#############################.#####.
#.............#.............................#....E
##################################################
##################################################
