##################################################
#S....#..............#..............#..........#
#.####.#.############.#.############.#.########.#
#.#....#.#..........#.#.#..........#.#.#......#.#
#.#.####.#.########.#.#.#.########.#.#.#.####.#.#
#.#.#....#.#......#.#.#.#.#......#.#.#.#.#..#.#.#
#.#.#.####.#.####.#.#.#.#.#.####.#.#.#.#.#.##.#.#.#
#...#......#.#....#...#...#.#....#...#...#.#....#
###########.#.#.###############.#.###############
#...........#.#.................#...............#
#.###########.###################.#############.#
#.#...........#...................#...........#.#
#.#.###########.###################.#########.#.#
#.#.#...........#.........#.........#.......#.#.#
#.#.#.###########.#######.#.#######.#########.#.#.#
#.#.#.#...........#.....#.#.#.....#...........#.#.#
#.#.#.#.###########.###.#.#.#.###.#############.#.#
#.#...#.#...........#.#.#...#.#.#...............#.#
#.#####.#.###########.#.#####.#.#################.#
#.......#.............#.......#.................#
###############.#########################.########
#...............#.........................#......#
#.###############.#########################.#.#####
#.#...............#.........................#.#...#
#.#.###############.#########################.#.#.#
#.#.#...............#...............#.........#.#.#
#.#.#.###############.#############.#.#########.#.#
#...#...............#.............#.#...........#.#
#########.#######################.#.#############.#
#.........#.......................#...............#
#.#########.#############################.#########
#.#.........#.............................#.......#
#.#.#########.#############################.#####.#
#.#.#.........#...................#.........#...#.#
#.#.#.#########.#################.#.#########.#.#.#
#.#.#.#.........#...............#.#.#.........#.#.#
#.#.#.#.#########.#############.#.#.#.#########.#.#
#...#.#...........#.............#...#...........#.#
#####.#############.#############################.#
#...................#.............................#
#.#################.#############################.#
#.#.................#...............#.............#
#.#.###############.###############.#.###########.#
#.#.#...............#...............#.#.........#.#
#.#.#.###############.###############.#.#.#######.#.#
#...#...............#...............#...#.......#.#
#############.#############################.#####.#
#.............#.............................#....E#
##################################################
